5 2 1 0 1 2 1 0 1 2 2 0 3 4 1 0 1 4 1 0 2 1 4 0 
2 2 4 0 3 5 4 0 4 3 2 0 3 3 1 0 5 3 1 0 2 5 3 0
2 1 3 0 4 1 5 0 4 1 2 0 3 2 4 0 2 2 4 0 2 2 2 0
2 3 3 0 4 4 2 0 4 4 2 0 3 4 5 0 2 4 5 0 2 2 4 0
1 2 1 0 1 2 1 0 5 2 2 0 3 3 4 0 2 3 4 0 2 2 3 0
2 4 3 0 2 3 5 0 2 3 2 0 3 2 4 0 5 2 4 0 2 5 2 0