5 2 1 2 0 0 0 0 4 2 2 0 0 0 0 4 1 1 2 1 4 1 
2 2 4 2 0 0 0 0 3 5 2 0 0 0 0 3 1 1 2 5 3 1
2 1 3 2 0 0 0 0 1 1 4 0 0 0 0 2 4 4 2 2 2 4
2 3 3 4 0 0 0 0 4 2 3 0 0 0 0 4 5 5 2 2 4 5
1 2 1 2 0 0 0 0 2 3 2 0 0 0 0 3 4 4 2 2 3 4
2 4 3 4 0 0 0 0 3 1 2 0 0 0 0 2 4 4 2 5 2 4